#################################
#........T......................#
#...............................#
#..................^............#
#..............##########.......#
#......#####....................#
#..P............................#
########.....#############......#
#...............................#
#...............................#
#......................^........#
#.............###################
#...............................#
#...............................#
#..........######################
#..........#....................#
#.......^..#....................#
#.....######....................#
#...............................#
#..........................D....#
#################################

